KJV	Modern Definition
Abase	To make or bring low, to humble
Abased	Humbled
Abate	To diminish, lessen
Abba	Aramaic/Hebrew for "father"
Abhor	To shrink from, be averse to, differ from, despise, spurn, regard with horror
Abide	Wait, stay, remain, endure
Abjects	Revilers, those who strike out with their tongue
Abode	Remained
Abominable	Detestable, impure, stinking
Abomination	Detestable, impure, stinking
Abound	Many, over and above, enough
Abounding	Many, over and above, enough
About	Around
Abroad	Broadly, outside, away from, become known
Accept	Approve, be gracious to, show partiality to
Acceptable	Pleasing, gratifying, agreeable, welcome
Account	Reckon, thought, answer
Accounted	Reckon, thought, answer
Acquaint	To get to know something or someone
Acquit	To hold guiltless
Adamant	A very hard stone, an extremely hard substance
Adder	A venomous snake
Addicted	Devoted to, given over to
Adjure	Request, demand of, to appeal to earnestly, to command
Admiration	Wonder, astonishment, to marvel at
Admire	Wonder, astonishment, to marvel at
Admonish	Testify, recommend, say repeatedly, to instruct, advise, warn
Admonition	Testify, recommend, say repeatedly, instruction
Ado	Fuss, bother, tumult
Adoption	Son-ship
Adventure	To chance, to risk, attempt
Advertise	To tell or inform
Advice	To take counsel with, or consult, to be discreet
Advise	To take counsel with, or consult, to be discreet
Affect	To try to obtain something, to aspire to something, make an effort, to use zeal
Affection	An emotion (not necessarily favorable)
Affections	Passions
Affinity	A marriage relationship or alliance
Afflict soul	Fast (abstain from eating)
Affright	Terrify
Affrighted	Terrify
Afoot	By feet, performed by foot
Afore	A prior time, previously, before
Aforehand	A prior time, previously
Aforetime	A prior time, previously, at a former time, previously
Afresh	Anew, again
After	Similar to, like something, according to
After a time	Immediately
Again	Back
Against	Opposite, across from, confronting, by
Agone	Ago, gone by, past, ago
Ague	Fever
Alarm	To arms, a call to battle
Albeit	All be it, shortened form of "although it be that", even though, although
All the world	Roman empire
Allege	To prove, to show evidence
Alleluia	Praise ye the LORD!
Allied	Joined by marriage, kinship, or treaty
Allow	To praise, approve or accept
Alms	Acts and deeds of mercy
Almsdeed	An act of kindness
Aloof	At a distance, but within view
Amaze	Stun, terrify, faint
Amazement	Stun, terrified, faint
Ambassage	An ambassador, an embassy, a group of aged, high ranking men
Amen	Dependable, faithful, certain
Amend	Mend
Amerce	A fine or penalty, to punish by fine
Amiable	Lovely, dear, beloved
An end	Fulfillment
Anathema	An accursed thing
Angel	Messenger
Angle	A fishhook
Anoint	To rub in, rub on
Anon	Immediately
Another	One of the same sort, or one of a different sort
Answer	Defend, to defend
Answered	Defended, to defend
Antichrist	One opposed to Christ
Antiquity	Ancient
Apace	To walk, get away
Apostle	Messenger, one who has been sent
Apothecary	A druggist, pharmacist, any who makes perfumes
Apparently	Visibly, plainly, distinctly
Apple	The pupil of the eye
Apprehend	Take possession of
Approve	Prove
Approved	Tested, tried, acceptable
Archangel	Chief angel
Aright	Upright, good, make good use of
Ark	A box, chest, basket
Armhole	Armpit
Armoury	Treasury, heap of swords
Array	To clothe, clothing To set in order for a purpose
Art	Skilled work, "Are"; second person singular
Artificer	Engraver, carver
Artillery	Any weapon of war
Ascribe	To give unto
Asp	A snake, serpent
Assay	To attempt, to test, to undertake
Assent	To agree upon
Asswage	To abate, diminish, settle down, subside, hold back
Astonied	To caste out, to drive out with a blow To stun, overwhelm, appall, horrify, terrorize, to be taken by surprise
Astonish	To caste out, to drive out with a blow To stun, overwhelm, appall, horrify, terrorize, to be taken by surprise
Astonished	To caste out, to drive out with a blow To stun, overwhelm, appall, horrify, terrorize, to be taken by surprise
Astonishment	To caste out, to drive out with a blow To stun, overwhelm, appall, horrify, terrorize, to be taken by surprise
Asunder	Between, apart from one another
Asuppim	Granaries, storehouses
Atonement	A covering (for sin)
Attendance	To pay attention, take seriously
Attent	Attentive
Audience	Listening or hearing
Aught	Any
Austere	Harsh, rough, severe, exacting
Avail	Be strong, have power
Averse	To turn away from
Avoid	Retreat from, evade
Avouch	To say, to acknowledge of one's own
Away with	Tolerate, endure
Axletree	Cross bar, axle, spindle of a wheel
Backbite	Slander, talking behind the back, to falsely accuse
Backbiter	Slander, talking behind the back, to falsely accuse
Backbiteth	Slander, talking behind the back, to falsely accuse
Backbiting	Slander, talking behind the back, to falsely accuse
Backsliding	Faithlessness, apostasy
Bakemeats	Baked pastries, the works of a baker
Baken	Anything baked
Balm	Medicine, gum/rosin from a bush
Band	Something that binds or ties up
Banquet	A feast of drinking, a drinking bout
Banquetings	A feast of drinking
Baptize	To immerse, to dip or dye a thing
Barbarian	A foreigner, non-Greek
Barbarous	A foreigner, non-Greek
Bare	Took out
Barked	To strip off, as bark from a tree
Base	Lowly, humble
Baser	Lowly, humble
Basest	Lowly, humble
Bason	Basin
Bath	A fluid measure, about 8 gallons
Battlement	A restraint or wall around the edge of a roof, something stretched out, a retaining wall
Bay	A reddish-brown color
Bdellium	An oily gum the color of a pearl,
Beast	A wild animal, or a man acting like a wild animal
Became	Was exactly suited for, was fitting
Because	That
Bed chamber	Bedroom
Bed stead	An elaborate and rich couch or bed, an arched bed
Beeves	Cattle, oxen, horned cattle fit to plough
Befall	To meet, chance
Beforetime	Previously
Begat	To bring forth, bear offspring
Beget	To bring forth, bear offspring
Begotten	To bring forth, bear offspring, to have born
Beguile	Deceive, to judge against, to lead astray
Behemoth	A huge, strong animal
Behove	To be necessary, needful
Behoveth	Being behooved, something owed or necessary
Belie	Be false
Belied	To lie against, to speak falsely
Bemoan	Rock, move, lament
Benevolence	A debt, something due to another
Beryl	A precious stone
Beseech	Plead, to call upon, appeal, beg
Beset	To surround, go around, encompass
Besom	A broom or sweep
Besought	Asked for, entreated, called
Bestead	Hard pressed, in a difficult situation, oppressed
Bestow	From "stow", or store, what you do with something, or where you put it
Bethink	To realize something, "Lay it to heart", consider and repent
Betimes	Soon, promptly, early, quickly
Betwixt	Between, in an intermediate position
Bewail	To wail, lament
Bewitch	Amaze, to fascinate
Bewray	To reveal or disclose, to make manifest, clear, evident
Bier	Device on which dead bodies were placed
Billow	A swelling or heap of water
Bishop	An overseer
Bishopric	Office, guardianship, office of overseeing
Blain	A blister or boil
Blains	Blisters, inflamed skin tumors
Blasted	A blight of mildew on plants
Blasting	A blight of mildew on plants
Blessed	Happy
Bloody flux	Dysentery
Boisterous	Strong, mighty, powerful
Bolled	A bud that is ready to open, as "a cotton boll", blossomed, in the seed/pod
Bolster	Head-rest, pillow
Bond maid	Maid-servant
Bond man	Slave, servant
Bond servant	Slave, servant
Bond woman	Maid-servant
Book	A legal document or scroll
Booties	The loot or spoil
Bosom	Have an intimate relationship with
Boss	The projection, or circular swelling, in the middle of a shield
Botch	A sore or boil, an ulcer
Bottles	Wineskins
Bound	Landmark
Bow	To curve or incline, to lean, to bend
Bowels	Usually an internal yearning or feeling, internal pangs of emotion, both good and bad, occasionally the internal organs
Brasen	Brass, copper
Bravery	Fancy female garments, beauty, splendor
Brawler	One who is inclined to fight
Bray	Pound or brake up, as with a mortar and pestle The sound of an ass or mule
Brayed	To groan, wail, make a foul noise
Breach	A damaged place, an opening or discontinuity
Breaches	Bays, harbors, creeks
Break up	To divide
Breeches	Trousers
Brigandine	Light armor made of chain mail or metal plates sewed to a cloth or leather coat, worn by foot soldiers known as "brigands"
Brim	Edge or border, a vessel full to overflowing
Brimstone	Sulfurous bitumen or pitch
Broided	Twined, braided
Broidered	Decorated garments
Broken	Opened
Brood	A group of young animals
Bruit	News being spread about, report, rumor
Brutish	To be like an animal, stupid
Buckler	A small round shield, either held in the off hand or strapped to the arm
Buffet	To strike with the fist
Bullock	Young bull, ox
Bulrush	Reed
Bulwark	Fortress, strong object, a defensive structure
Bunch	A hump on the back of a person or camel
Burden	Something carried, either literal, or a message from god
Burn	Passionate emotion, of lust, anger, or indignation
Burnished	Polished
Bursting	Shattered, crushed, broken into pieces, beaten
Business	From "busyness" to be active, have diligence, eagerness, earnestness
Butlership	The office of a butler
Buttocks	The seat, the posteriors, the rear end
By	Against
By and by	Immediately, at once, without delay
By course	In turn, orderly progression
Cabin	A prison or dungeon cell, a vaulted cell
Calamus	A reed
Caldron	A pot or kettle
Calker	Repairer of a breach or seam
Camphire	Henna
Candle	A lamp or lamp stand, using oil and a wick
Candlestick	A lamp or lamp stand, using oil and a wick
Canker	Gangrene, a dying or decay of a part of the body
Cankered	Rusted
Cankerworm	A caterpillar or larva that eats buds or leaves
Cannot contain	Unable to exercise sexual self-control
Captivity	Exile, prison, subjection to a foreign power, or the people in that condition
Carbuncle	A precious stone, usually red
Carcase	A dead body
Care	Anxiety, earnestness, diligence, zeal
Careful	Anxiety, earnestness, diligence, zeal
Carefulness	Anxiety, earnestness, diligence, zeal
Carnal	Fleshly, of the flesh, denoting human nature
Carnally	Fleshly, of the flesh
Carriage	That which is carried, not the vehicle carrying, baggage
Casement	Lattice window
Cassia	The bark of a cinnamon-like tree
Cast	Worn-out, old, cast-off
Cast angle	To fish with a hook
Cast down	To put something in position, to set in place
Cast in his teeth	To revile
Castaway	Rejected or unfit, not worth keeping
Caul	The diaphragm or pericardium. A knitted cap, a membrane covering (anatomy)
Cauls	Embroidered works, networks
Cause	Reason
Celestial	Relating to the heavens, heavenly
Censer	A small altar for burning incense
Centurion	Leader or commander of a hundred men
Certain	Some
Certify	To make known, advise
Chafed	Aggravated, displeased to the point of animosity
Chaff	The husk of wheat left after threshing, carried away by the wind
Chalcedony	A form of agate
Chalk stone	Limestone
Chambering	Immoral behavior behind closed doors, lewdness
Chamberlain	An officer of the king's court, the chief servant, normally a eunuch
Champaign	An open plain or desert, a plain, level country
Changeable (suits of apparel)	Garments worn during feasts or on special occasions
Chapiter	The capital or top of a column or pillar
Chapmen	Traders, merchantmen
Chapt	Cracked open topsoil during a drought
Charge	Responsibility, burden
Chargeable	Burdensome
Charged	Burdened, weighed down
Charger	A platter big enough for a large roast, a dish, a plate
Charitably	In love
Charity	Spiritual love
Charmer	A juggler, magician, sorcerer
Chaste	Consecrated, untouched, undefiled
Chasten	To discipline, train, educate
Check	Reproof, rebuke
Checker	Latticework
Chide	Rebuke, find fault, contend, strive
Chief estates	Leading men
Chiefest	The best, choicest
Choler	Bitter anger, anger
Chrysoprasus	A precious stone
Church	An assembly of persons, a congregation, assembly of "called out" ones
Churl	Rude and vulgar person, deceitful, sly, cruel, stubborn
Churlish	Rude and vulgar person, deceitful, sly, cruel, stubborn
Ciel	Paneled or paneling of wood, rafters
Cieling	Paneled or paneling of wood, rafters
Circumspect	Watchfully, pointedly, carefully
Circumspectly	Watchfully, pointedly, carefully
Cistern	A well, pit or vessel for holding water
Clamorous	To make a noise, an outcry or protest
Clave	To split, to break through, tear
Clay	Mud
Clean	Completely, entirely In 2 peter 2:18, barely
Clean heart	Right attitude
Cleanness of teeth	Famine
Cleave	To adhere closely to, to be joined to, to be united
Cleaveth	To stick close to
Cleft	A rent open or hollow place, a fissure in the rock, an opening, break or split
Clift	A rent open or hollow place, a fissure in the rock, an opening, break or split
Cloak	An outer garment, a covering or robe, raiment, clothing
Cloke	An outer garment, a covering or robe, raiment, clothing
Close	A stronghold, a safe place
Closet	A private room or chamber
Clothed upon	To put a garment on over other garments already worn
Clout	A rag or used piece of cloth Patches on an old garment
Clouted	A rag or used piece of cloth Patches on an old garment
Cloven	Separated, divided up
Coast	The border or outskirts of a region, not necessarily at the sea
Cockatrice	Venomous serpent or lizard, a viper
Cockle	A weed resembling wheat
Coffer	A box or chest, usually for storing wealth
Cogitation	Thoughts
College	A particular district or quarter of a city, as "the Hebrew quarter, or the Moslem quarter of Jerusalem”
Collop	A piece of flesh
Collops	Fat, fatness
Come	Follow
Come by	To bring a boat to a desired heading
Comeliness	Honor, beauty, gracefulness That which is fitting
Comely	Honor, beauty, gracefulness That which is fitting
Comfort	To support or strengthen, to exhort
Comfortable	To put at rest
Comfortably	Speak encouragingly
Comforter	An advocate (lawyer), one who comes alongside to support, a title of the holy spirit
Comfortless	Not left as orphans
Coming	Revelation
Commend	To praise
Common hall	Praetorium
Commune	To confer and discuss with someone else
Communed	Reasoned
Communicate	To share fellowship or material aid, social interaction, to share or have things in common
Communication	To share fellowship or material aid, social interaction, to share or have things in common
Communications	Associations, companionships
Compacted	Knit together
Compass	To encircle or surround, to go round about
Compel	To urge, attempt to force
Comprehend	To lay hold of, apprehend, to grasp, to overcome
Conceit	Imagination, high-mindedness
Concision	To mutilate the flesh, a cutting off, a false circumcision
Conclude	To restrict, confine, shut up, come to a decision
Concluded	Shut up, shut together, enclosed
Concord	Agreement, unison
Concourse	A gathering, a crowd of people
Concubine	A half wife, a secondary or inferior wife
Concupiscence	Eager sexual lust, strong desire, passion
Condescend	The opposite of haughty behavior, humility, to go along, to be led
Coney	A small animal similar to a groundhog
Confection	Something spicy or good smelling, a perfumer, ointment maker
Confectionary	Something spicy or good smelling, a perfumer, ointment maker
Confer	To speak or talk together
Confound	Dismay, put to shame, bewilder
Confusion	Embarrassment, shame
Consecrate	To regard as set apart or separate
Consent	To agree with enthusiastically, be readily like minded
Consort with	To be joined to
Constant	To continue steadfastly, to be confident of something
Constantly	To continue steadfastly, to be confident of something
Constrain	To compel
Consult	To plan or scheme
Contemn	To loath, refuse or despise To be lightly esteemed, to despise with mockery
Contemned	To loath, refuse or despise To be lightly esteemed
Contemptible	Despicable, worthy of nothing
Content	To be satisfied, to accept a situation
Contentious	Loving quarrel, fond of strife
Contrariwise	On the contrary
Contrite	Crushed, broken or bruised in spirit
Convenient	Proper, fitting, apt, an opportunity, appropriate
Conversation	Manner of life, behavior, conduct does not refer to discussions, one's conduct, manner of walk
Convince	To convict or prove, to carry the force of an argument
Convinceth	Convict
Convocation	A calling together, assembly
Coriander	A round aromatic seed
Corn	A grain or small round object, or a cereal, not referring to maize or Indian corn
Cornet	A wind instrument, horn, trumpet
Corrupt	Physical decay such as rust or rotting, or moral decay
Cote	1) Livestock shed, 2) Fold
Coulter	Colter. A plowshare, an iron agricultural tool
Countenance	Face, appearance
Countervail	To make up for, balance out, be made equal, offset, compensate
Country	Countryside, rural area
Coupled	Joined together, attached Twins
Cousin	A kinsman or relative
Cover his feet	A euphemism referring to a bowel movement Where the clothes are at that time
Covert	A covered walk. A hiding place
Covet	A strong desire to possess what belongs to another In 1 COR 12:31, a good spiritual zeal, to long after, to try to gain
Cracknel	A crunchy biscuit, small dry cake, cracker
Creature	Anything created, the creation
Crib	A place in which cattle are fattened
Crisping pins	Money bags or purses, highly ornamented
Crook backt	Hump backed
Crop	To pluck or break off
Cross	Stake
Cruse	Bottle, jug or flask, a pot
Cubit	A linear measurement, about 18 inches
Cumber	A bother, to be distracted with cares
Cumbereth	To render useless, to make vain
Cumbrance	A burden
Cummin	A herb bearing aromatic seeds
Cunning	In the OT, skillful In; the NT, sly or devious
Curious	Made with care and skill, from the idea of being carefully watched over
Curious arts	Magic
Dam	A mother
Damnation	Condemnation, judgment
Damned	To condemn, judge against
Damsel	A little girl or maiden
Dandled	To be soothed, caressed, fondled
Danger	Liable to, a legal phrase connoting liability
Darling	An only one, something unique and beloved
Dash	To strike, break, shatter, to beat towards
Daub	To cover or plaster
Daysman	Go-between, arbitrator, a judge, an umpire
Dayspring	The start of the day, an "up-rising", hence sun rising
Deacon	Servant, attendant
Dearth	Something lacking, a cutting off of rain
Debase	To make low or humble
Debate	A hateful argument, violent actions
Decay	To waste away, diminish, become obsolete
Deck	Adorn oneself
Declare	To explain in detail, make a report
Decline	Deteriorate in moral standards
Deem	To suspect
Defame	To slander, speak evil of
Defence	Fortress, stronghold, high tower Shade
Defer	To delay, postpone
Defiled	Ritually unclean
Degenerate	Having fallen from a desirable state
Degree	Stairs or steps, going up or down. A person's social rank
Delicacy	Sensual pleasures, wantonness
Delicately	To enjoy luxury
Deliciously	Sensual pleasures, wantonness
Delivered	Entrusted to
Delivered up	Handed over
Demand	An inquiry, to ask
Denounce	To announce something, give forth a proclamation
Deputy	A person who acts or speaks for another
Derision	Ridicule, laughing at enemies' threats
Descry	To look at something, to reconnoiter, to spy out
Despite	Spiteful, to insult or scorn, contempt
Destitute	Those whose souls have been laid bare
Determinate	Marked out
Determine	Decide
Device	A plan or purpose
Devil	An accuser
Devotions	Objects of worship
Diadem	Tiara, crown, turban or hood
Die the death	"Surely die"
Dig up	To dig a pit to ensnare someone, to devise evil
Disallow	To refuse to accept or sanction, a rejection
Disannul	Make null and void, to abolish a vow, to break
Discern	To recognize someone you used to know, examine, prove or test, scrutinize
Discomfit	Defeat or repel an enemy, or confuse the plans of an attacker, to disturb
Discover	To expose or reveal, to come in sight of
Disdain	To reject, to despise
Dishonesty	Underhanded methods
Disorderly	To be lazy, failure to work
Dispensation	An arrangement of things, a scheme
Disquiet	Roar, make a noise Emotional distress
Disquietness	Roar, make a noise Emotional distress
Dissemble	Lie, lead astray, to use deceit, to feign
Dissemblers	Pretenders, hypocrites
Dissembleth	To pretend, to use deceit
Dissimulation	Hypocrisy
Distaff	The part of a weaving loom that holds the flax or wool for spinning
Distil	To flow or drop water
Divers	Different, unequal, various
Diverse	Various
Dividing	Expounding, dissecting
DOCTOR	Teacher, instructor
Doctrine	Teaching, the act or result of teaching
Dogs	An obnoxious beast, a foreigner or gentile
Doleful	Howling, shrieking
Done away	Faded away, removed
Dote	To be foolish, to fixate on a topic constantly, as if feebleminded
Doth	To do, to produce, make
Doting	To appear to be ill, or sick over
Doubt	Something perplexing, causing questions
Doubtful	Dubious in value, anxious
Doubtless	Having certainty
Dragon	Jackal, wild dog
Draught	To drain To catch in a fishing net, an outhouse
Drave	Drove, had driven
Dreadful	Having awe or reverence for something
Dregs	Sediment
Dropsy	An illness
Dross	The useless leftovers when metal is refined
Drove	Flock, company
Dryshod	Footed with shoes
Due benevolence	Sexual dues
Duke	A chieftain, a head of a family or tribe
Dulcimer	Musical instrument similar to a hammered dulcimer
Dure	To endure
Dureth	To endure, to last
Durst	Dare not speak
Ear	To work, till, or plough the ground
Earing	Plowing, tilling the ground
Earnest	A down payment guarantee promising that the balance owed will be paid, a pledge
Earnestly	Carefully, steadfastly
Earth	Land
Easter	Passover
Edify	To build up spiritually or intellectually, to construct, build up or establish
Effectual	Effective service, active work
Elder	Older, greater in age
Elect	Chosen, according to choice
Election	Chosen, according to choice
Elias	Elijah
Eliseus	Elisha
Embolden	To make powerful
Embraced	Greeted
Emerods	Hemorrhoids, tumors
Eminent	High or lofty, something raised up high
Emulation	In ROM11:14, encouraging another to zealousness In Gal 5:20, an envious and contentious rivalry, jealousy
Engine	Warlike invention
Engines	War machinery, ballistae, battering rams
Enjoin	To charge, arrange, make responsible, to command
Enlarge	To make greater, as a blessing
Enlargement	To set free from confinement
Enmity	Hostility, hatred
Ensample	Example
Ensamples	Examples, types, a banner, sign, memorial
Ensue	To seek after, to pursue after
Entice	Bait or persuade
Enticing	Bait or persuade
Entreat	Intreat, ask, desire, to treat, to use
Entreaties	Pleadings, humble requests
Environs	To surround, compass
Ephah	A unit of measurement, roughly three pecks plus five quarts
Ephod	A priestly garment
Epistle	A letter, a letter sent
Equal	To be just and fair
Equity	Uprightness, straightforwardness
Ere	Before
Esaias	Isaiah
Eschew	To escape or avoid, turn aside
Espousals	The wedding ceremony
Espoused	Betrothed, to be asked in marriage
Espy	See, watch, search out
Estate	Order, condition, council
Estates	Men
Esteem	To think, reckon, set a value on
Estrangled	To be a stranger
Euroclydon	A furious, north-easterly wind
Evangelist	Messenger of good tidings
Eveningtide	Evening time
Eventide	Evening time
Every	Per each
Every man	Every thing
Every several	Each individual, each one separately
Every whit	Whole, all
Evidence	An assurance, a legal document, a deed
Evidently	Apparently
Evils	Demons
Exact	To cause to come out, take
Exaction	To cause to come out, take
Exactor	Overseer
Exceed	To go to excess
Exceeding	To a great extent
Excellency	Excellence
Execration	Oath, curse
Exercise	To practice, be busy with, occupied with
Exhortation	Encouragement
Expect	Wait
Expectation	Hope
Expound	To set forth, to declare
Extol	To lift up, esteem, praise
Eye of a needle	The animal gate, next to the main city gate, where livestock were permitted to enter (the main gate was for human traffic only).  Most livestock were goats and sheep, but horses and donkeys could enter easily. The very rare camel was so large it was required to kneel and crawl through
Eyesalve	Medicine for the eyes
Eyeservice	Only while being watched
Fable	A myth
Fain	Gladly, to desire earnestly, long for
Faint	To grow weak or lose courage, to give up
Faith	Faithfulness
Faithful	Trustworthy
Fame	Something commonly known, or a rumor
Familiar spirit	The spirit or demon that prompts a medium or fortuneteller
Familiars	Close friends, intimate friends
Famished	To have suffered hunger
Fan	A grain winnowing fork or shovel, winnowers
Fanner	A grain winnowing fork, winnowers
Fare	To make merry, rejoice
Farthing	Money, a tenth of a denarius, a small coin of little worth
Fashion	The plan or likeness of something
Fast	To be close to, abstaining from food
Fat	As an adjective- flourishing, healthy
Fathom	Approx 6 feet
Fatling	Fat cattle
Feebleminded	To be discouraged or depressed, weak in spirit Does not imply mental retardation, Faint-hearted
Feign	To pretend
Feigned	Deceit, pretending, false
Feller	One who cuts down
Felloes	Spokes of a wheel
Fellowship	Partnership
Fen	A swamp or mire, a marsh
Fenced	From defense, a fortification, protected
Fervent	Glowing, ardent, zealous, earnest, burning
Fetch a compass	To make a circuit, a 360 degree turn
Fetch about	To bring about
Fetched a compass	Made a circuit, wandered up and down
Fetters	Bonds, chains
Fillet	A narrow strip or band of material, usually between two other things, curtain rods placed between columns
Filthy conversation	Immoral conduct
Fine	As a verb- refine
Fining	Refining
Firebrand	Firewood, torch
Firkin	Liquid measurement
Firmament	Expanse or vault over the earth, sky
Firstling	First offspring, firstborn
Fitches	A grain, black cummin, a species of grain
Flag	Type of marsh grass or reed
Flagon	A pressed cake of raisins, a cup, bottle, vessel
Flags	Plants growing in moist places
Flanks	The loins
Flay	To strip off
Flight	Escape
Flood	Flowing water
Flowers	Menstrual flow, blood
Flux	Dysentery, an intestinal disease
Folden	Folded up, interwoven, tangled
Followers	Imitators
Footmen	Foot soldiers, guards
For a season	For a short time
For that	Because
For to	To
Forbear	Cease, be silent, hold back, to let alone, to be silent
Forbearance	Self-restraint
Forbearing	Patience, slow anger
Forborne	Ceased
Ford	A river crossing, where a river can be crossed by foot
Foresaw	Beheld
Foretell	To advise someone ahead of time
Fornication	Sexual immorality
Forsaken	To leave in an abandoned condition
Forsook	To have left in an abandoned condition
Forswear	To swear falsely
Forth of	Out from
Forthwith	Immediately
Forward	Eagerness or readiness to advance a good cause
Forwardness	Eagerness or readiness to advance a good cause
Fountain	Spring
Fourscore	Eighty
Foresquare	Squared, four cornered
Fowler	One who catches birds with a snare
Fowls	Birds
Frame	To arrange, set forth
Frankly	Generously
Fray	To make afraid, frighten
Fret	To corrode, pit, pitted, to be grieved, troubled, displeased
Fretting	To corrode, pit, pitted
Frontlets	A phylactery worn on the forehead
Froward	Crooked or perverse, devious or sneaky, perverse, deceitful, false
Frowardly	Crooked or perverse, devious or sneaky
Frowardness	Crooked or perverse, devious or sneaky
Fulfill	Gratify
Fuller	Launderer, one who washes clothes
Furbish	To scour and cleanse metal
Furbished	Polished
Furlong	A tenth of an English mile, or approximately 1/8 mile (660 feet)
Furniture	Furnishings, utensils
Furrow	Groove in the earth made by a plow
Gad	To go about or away, to roam
Gaddest	To go about or away, to roam
Gainsay	To speak against, oppose, contradict
Gainsayers	To speak against, oppose, contradict
Gainsaying	To speak against, oppose, contradict
Gall	Bitter, poisonous, venomous
Galley	Ship with oars
Gape	To open wide
Garden house	A summer house
Garlick	Garlic
Garner	Treasury for grain, a barn, a storehouse
Garnish	To be well furnished or prepared
Garrison	A guard, watch or patrol
Gay	Excellent, fine, expensive, costly
Gazing stock	A public spectacle
Gender	To breed something for a specific purpose
Generation	A genealogy, a particular race of people, a group of people living at the same time
Gentiles	A people, nations other than Israel
Ghost	Spirit
Gier eagle	The Egyptian vulture
Gin	A snare or trap, a noose
Gird	To wear, bind on, put on securely, a sash or belt, to fasten, secure, to equip, prepare
Girded	To wear, bind on, put on securely, a sash or belt, to fasten, secure, to equip, prepare
Girdle	To wear, bind on, put on securely, a sash or belt, to fasten, secure, to equip, prepare
Girt	To gird around, be girded, to be belted, wrapped
Give place	Make room, yield to another
Glass	Highly polished metal used as a mirror
Glean	To gather crops
Gleaning	To gather crops
Glede	A vulture
Glister	Glittering, dazzling
Glistering	Glittering, dazzling
Gnash	To grate the teeth
Go to	An exhortation or command
Goad	A pointed stick
God forbid	A strong objection, "may it not be so!"
God speed	To wish someone divine success, a greeting
Going forth	Origin
Goings	Steps, a path followed
Good master	Good teacher
Goodly	Beautiful, handsomeness, physical excellence
Goodman	Male homeowner, male head of a household
Goods	Possessions
Gospel	Good news
Governor	The pilot or helmsman of a ship, a ruler
Grace	Kindness, favor
Graven	Something sculptured, carved Engraving, to cut or engrave
Graving	Something sculptured, carved Engraving, to cut or engrave
Gravity	Dignity
Greivous	Severe, harsh, difficult to bear
Grief	Any distress or injury, not necessarily emotional
Grieve	Any distress or injury, not necessarily emotional
Grievously	Severe, harsh, difficult to bear
Grievousness	Severe, harsh, difficult to bear
Grisled	Gray, or streaked and mixed with gray, spotted, speckled
Gross	Fat, thick
Ground	To lay a foundation, secure, stable
Grounded	To lay a foundation, secure, stable
Grudge	Complain or grumble
Guile	Deceit, craftiness
Guilty	Bound
Habergeon	A short coat of mail without sleeves, a coat of armor
Haft	The handle of a dagger, a handle
Hail	A greeting of joy and peace
Hale	Haul, drag by force, to draw
Haling	Haul, drag by force
Hallow	To make holy, to set apart from common
Hallowed	Set apart
Halt	Lame, limping, crippled in the feet
Hand	Defiantly, overbearing
Handmaid	A female servant
Handmaiden	A female servant
Hang	To be crucified
Hang oneself	To confess to a crucify-able crime
Hap	Perhaps, by chance
Haply	Perhaps, by chance
Hard by	Beside, next to
Hardly	With difficulty
Hardness	Blindness
Harlot	To commit fornication, sell the body
Harness	As a noun - armor
Harrow	A sharp, pointed instrument
Hart	A male deer, a stag
Haste	To hurry, to urge on quickly
Hastily	Without delay
Hasting	Without delay
Haughtily	Prideful, to be high
Haughtiness	Prideful, to be high
Haughty	Prideful, to be high, proud, arrogant, lifted up
Haunt	To inhabit, visit or dwell
Headlong	To fall forward
Heady	Passionate, headstrong, reckless, hasty, headstrong
Health	A cure or recovery Salvation
Hearken	Listen, pay attention
Heart	Attitude of mind
Hearth	A furnace, fire
Heath	A bare wilderness, a shrub or tree
Heathen	People, nations, non-Jews
Heave offering	An offering which is waved or held out toward the lord
Heavily	A sorrowful or distressed state of mind
Heaviness	A sorrowful or distressed state of mind
Heed	Pay close attention, to be careful to consider
Hell	The valley of Hinnom
Hence	Therefore, from this
Henceforth	From this time forth, from now on
Herbs	Vegetables
Herdman	One who feeds animals, a shepherd
Hereafter	After this
Hereof	This
Heresies	Factions
Heretic	One who causes divisions, factions
Heretofore	Previously
Hereunto	Unto this
Herewith	With this
Heritage	Allotment, possession
Hewn	Cut
High	Defiantly, overbearing
Highminded	Haughty, egotistical
Hin	Five quarts, liquid measure
Hind	A female deer
Hinder	To delay, withhold, latter, rear, behind
Hinder (part)	The back part, rear
Hindermost	The back part, rear
Hindmost	The back part, rear
Hinds	Deer or mountain goats
Hireling	One hired, a laborer employed on hire
Hiss	Whistle
Hither	Here, to bring close
Hitherto	Up until now
Hoar	Gray headed, aged
Hoary	Gray headed, aged, white colored
Hock	To disable by cutting a leg muscle
Hoise	Hoist
Hold	Stronghold
Holden	Held, caught
Hollow	Palm, cup
Holpen	Helped
Homer	A half gallon dry measure
Honest	Honorable
Horse leach	One who tends to horses, a veterinarian
Hosanna	"Save now!", "Save, I pray!"
Hosen	A garment, possibly a coat - the meaning is uncertain, tunics, under garments
Host	Army, or band of soldiers
Hough	Pronounced "hock", to hamstring by cutting the large tendon just above the heel
House	A building, a household, a family, ancestry
Howbeit	Be that as it may
Hunger bitten	Famished
Hungered	To have been hungry
Husbandman	Farmer, farming
Husbandry	Farmer, farming
Husks	(OT) chaff, what the grain comes out of (NT) pods from the carob tree, suitable for feeding animals, and also eaten by the poor
Hyssop	A small shrub, a bitter herb
Ignominy	Shame, confusion, contempt, dishonor
Illuminate	Enlighten
Imagery	Pictures
Imagination	An evil plan or scheme
Imagine	An evil plan or scheme
Imitate	To follow as a role model
Immortal	Incapable of corruption
Immortality	Incorruption, an imperishable state
Immutable	Unchangeable
Impart	To share
Impenitent	Without remorse
Imperious	Hard-faced, bold
Implacable	Unyielding, obstinate
Implead	Take to court, to bring an accusation against
Importunity	Barefacedness, "staying in his face", a persistent begging and urging, lack of modesty, shamelessness
Impotent	Powerless, ineffective, crippled
Impudent	Strong of forehead, sharp of face, stubborn, hard-faced
Impute	To reckon or count
In any wise	Surely
In his	Have an intimate relationship with
In no wise	By no means, assuredly not
Inasmuch	Because
Incontinency	No self control in sexual matters, lack of self-control, unbridled, uncontrollable
Incontinent	No self control in sexual matters, lack of self-control, unbridled, uncontrollable
Indignation	Wrath, anger
Indite	A lively dictation of words to someone else
Inditing	Overflowing, boiling over
Infamy	An evil report
Infidel	An unbeliever
Iniquity	Lawlessness, sin, wickedness, evil
Injurious	To be insolent and insulting
Innumerable	Without number, many
Inordinate	A doting love, pathetic lust, without restraint, immoderate
Inquisition	To inquire, search out
Insomuch	So that
Instant	Earnestly, urgently, insistently
Instantly	Diligently, earnestly
Instructor	Male slave responsible for a boy to take him to school
Intelligence	To come to an understanding with another
Intermeddle	To mix or take part in
Intreat	To smooth down, be gracious, ask for
Intreated	To smooth down, be gracious, ask for
Intreaty	To smooth down, be gracious, ask for
Inventions	Thoughts, ideas, deeds
Inward	Intimate
Inwards	Entrails
Issue	A flowing, to go forth, a fountain, outgoings
Jacinth	A semi precious stone, like a reddish zircon
Jangling	Empty and useless, foolish talk
Jealous	Zealous
Jewess	A female jew
Joined hard	To border, to be adjacent to
Jonas	Jonah
Jot	An iota, the smallest letter in the Greek alphabet The Hebrew equivalent is Yod, a Y-shaped like a comma It is used to express the smallest thing
Judge	To condemn, sentence to judgment
Keep	Guard
Keep under	Buffet
Kerchief	A cloth covering for the head, a veil
Kin	Family
Kindred	Tribe, family
Kine	Horned cattle
Kinsfolk	Family, relatives
Kinsmen	Neighbors, relatives
Knew	Recognized, or had sexual relations with
Knop	A carved bud or flower
Knops	Decorative ornaments
Know	(var) to be sexually intimate
Lade	To load, loaded, to burden
Laden	Loaded, burdened
Ladeth	Burdens, loads
Lading	A burden, load, cargo
Lame	Crippled
Lancet	A spear
Languish	To become weak or sick, to wither, to be made weak
Lapwing	A hoopoe or woodcock
Lasciviousness	A shameless desire for passion, unbridled sensuality, excess
Latchet	A thong or shoelace
Latter	Last
Laud	To applaud, praise
Laver	A pan or basin for washing
Lawyer	Person skilled in the Law of Moses
Layeth	Store
Leasing	Lying, falsehood, deceit
Leathern	Made of skin
Leek	A vegetable similar to a green onion
Lees	The sediment left in the bottom of a wine barrel when the wine is drained off
Legion	An indefinite large number
Lentiles	Beans, and/or the plants from which they come
Let	To hinder or prevent, or sometimes exactly the opposite, to allow (context!)
Letteth	Restrains
Leviathan	An enormous sea serpent, a crocodile
Lewd	Vulgar or base actions
Lewdness	Vulgar or base actions, villainy, wickedness, crime
Libertines	Jews who had been captives at Rome, but had gained their liberty
Light	Reckless or unstable persons
Lightly	Easily or quickly
Lightness	Reckless or unstable persons
Like	Likely
Like unto	Corresponding
Liking	To be healthy and strong
List	A desire or wish, willed
Listed	A desire or wish, willed, to have pleased, chosen
Listeth	To please, to choose
Litter	A covered coach, a cart carried by others with poles
Lively	Vigorous, alive, living
Loft	Story (floor), roof
Log	A liquid measure, about two thirds of a pint
Loins	The lower back, waist
Longsuffering	To bear with patiently
Look for	Await
Lop	To cut off
Lot	Portion, destiny, fate
Lothe	Loath, loathing
Lothing	Loath, loathing
Lovingkindness	Mercy
Lowering	To appear gloomy, overcast
Loweth	To moo (cow noise)
Lowing	Mooing, making cow noises
Lucre	Dishonest gain
Lunatic[k]	Epileptic
Lust	Any eager desire for something pleasing to the flesh
Made manifest	To be made visible, to make clear
Magnifical	To make or become great
Magnified	To make or become great
Magnify	To praise or honor Exalt, boast
Maimed	To lose a limb, crippled, or deprived of some member
Maintenance	Upkeep, an allotment
Make	An interrogative, "what are you ?"
Make for	Incline toward
Malefactor	Evil doer
Malice	Ill-will, badness
Mallows	A flowering plant, or herb
Mammon	Wealth, riches, earthly goods, property
Mandrake	Some lovely fruit or flower
Mandrakes	love apple, a plant with mild narcotic properties, used as an aphrodisiac
Maneh	A weight, one sixtieth of a talent
Manifest	To make openly known, appear
Manifold more	Many times more
Manner	A kind or sort of something
Mansion	A place to live, a home or a room, an office, abiding place
Mantle	Garment, covering
Mar	Damage to uselessness
Marish	Marshy, pond
Marred	Ruined
Martyr	A witness
Marveled	Afraid
Maschil	A notation found preceding certain psalms, indicating that great skill is required to execute the music properly
Master	A teacher or lord, a rabbi
Matrix	Womb
Mattock	A grubbing hoe, spade, agricultural tool
Maul	A spiked club or mallet
Maw	The stomach
Mazzaroth	Stars, planets, the zodiac
Mean	Common, ordinary
Meat	Food of almost any description
Meat offering	Meal offering
Mediator	One who intervenes between two parties
Meek	Gentle, tender, free from pride
Meet	(var) right, proper useful, fitting, agreeable, fit, proper
Mene	To number
Menstealers	Kidnapper
Merchantmen	Merchants
Mercies	Compassion
Mercurius	Hermes, the god mercury
Mess	A serving of food, a portion, a gift
Messias	Anointed One
Mete	Measure out, weigh, to deal out
Meted	Measure out, weigh
Meteyard	A measure of distance, a measure of length
Michtam	A notation found preceding certain psalms, possibly indicating a particular tune, the exact meaning is uncertain
Milch	To suckle, giving suck, milking
Millet	A type of grain, a grain used for breads and cereals
Mince	To walk in an exaggeratedly dainty fashion
Mincing	Taking short, quick steps, tripping
Mingle	To mix
Minish	Diminish, to be made few
Minister	Attendant, servants
Ministration	Service
Minstrel	A player on a stringed instrument
Mire	Mud, clay-like soil
Mirth	Gladness, rejoicing
Miry	Muddy
Mistress	Female head of a house
Mite	A lepta, a copper coin worth about 1/8th of a cent, a Jewish coin
Mitre	The headdress or turban worn by the high priest
Mock	To verbally abuse, jeer at, or ridicule
Mocked	Deceived
Moderation	Graciousness or forbearance
Molten	A metal object formed by casting in a mold Melted metal
Moreover	Also, even, yet, and
Morrow	Tomorrow, the morning after
Morsel	A cake, food
Mortify	To put to death, to take away
Mote	A small dry particle
Motions	Emotions or impulses, passions
Mount	A siege mound or embankment used to assault a fortification
Mounting	Going up
Much	Many
Muffler	An ornament worn by women
Mufflers	A veil over the mouth
Munition	A fortress, stronghold
Murrain	A plague or pestilence
Muse	Meditate
Muster	Cause to assemble, inspect, to number
Myrrh	A substance derived from a form of balsam tree, used in the holy anointing oil, embalming, and as a perfume Has stupifying properties when mixed with wine
Myrtle	A small tree with green leaves and white flowers Allspice is made from it's dried seeds
Napkin	Handkerchief
Nard	Spikenard
Naturally	Truly
Naught	Bad or evil, useless, nothing, vain
Naughtiness	Wickedness, evil
Naughty	Wickedness, evil
Nave	Arched or concave
Nay	No, not
Necessity	Necessary
Necromancer	One who inquires of the dead
Needle's eye	The animal gate, next to the main city gate, where livestock were permitted to enter (the main gate was for human traffic only).  Most livestock were goats and sheep, but horses and donkeys could enter easily. The very rare camel was so large it was required to kneel and crawl through
Needs	Necessarily or of necessity
Neesing	Sneezing
Neginoth	Stringed instruments
Neigh	To cry aloud
Neighing	To cry aloud
Nephew	An offspring or descendant, grandson
Nether	The lower of two, something lower
Nettle	A stinging plant, a thorny shrub, prickly weed
Nicolaitans	From the Greek, nikao, to conquer – laos; the laity or people Those who divide the church into two groups: clergy and laity Some believe that the term refers to those who lived licentiously
Nigh	Near
Nitre	Carbonate of soda
No little kindness	Exceptional kindness
Noised	Heard
Noisome	Hurtful, bad, foul
None effect	No effect
Not a whit	Not the least bit
Nought	Nothing, having no value
Nourish	Nurture
Novice	A beginner or new Christian
Nurse	To suckle, as a mother her child
Nurture	Training, discipline
Obeisance	To bow down, show respect
Observe	Treat respectfully, care for, keep watch
Observed	Kept safe
Obstinate	Stubborn
Occasion	Opportunity
Occupy	Do business, a trade
Occurent	Occurrence
Odious	To be hateful, abhorrent, to stink, loathsome
Offend	A stumbling block, a snare
Offscouring	What is scraped off, scum, filth
Oft	Often, frequently
Ointment box	Flask
Omer	One half gallon dry measure
Omnipotent	All powerful, all mighty
On this wise	In this manner
Once	Ever, yet, still, any
Onycha	perfume crab, a type of mussel which emits a strong fragrance when it's shell is burned
Onyx	A dark green stone
Open	Explain
Or ever	Before
Oracle	The inner sanctuary, "Holy of Holies"
Ordain	Establish, appoint, decree, to form, to place
Ordinance	Tradition
Osee	Hosea
Ospray	An osprey
Ossifrage	bone-breaker, a large vulture that carries bones into the air and drops them on rocks to break them open, that it might eat the marrow
Ouches	Gold settings for jewels, sockets
Ought	Anything, any An obligation, something needful, any one
Out of	At once
Outgoings	The extreme edges of a country
Outlandish	Of a foreigner
Outwent	Went faster than another, to go before in advance
Overcharge	To excess, to overburden
Overcharged	To be weighed down, loaded
Overdrive	To drive a herd of animals too aggressively
Overlive	To outlive another person
Overpass	To go too far, trespass
Overpast	To be finished
Overrun	To run faster than another
Paddle	A spade point on the end of a lance, used for an entrenching tool
Pained	Anguish
Palmerworm	Caterpillar, or cutting locust
Palsy	Paralyzed
Pang	Pain, anguish
Paps	Nipples, breasts, bosoms
Parable	An utterance that involves a comparison
Paramour	A male or female lover
Pare	Prepare
Part	To distribute among several recipients
Partaker	To take part
Partial	To judge unfairly, show partiality
Particular	Individually, each, in detail
Passage	A place for people to pass through
Passenger	Traveler
Pastor	One who feeds the flock, shepherd
Pate	Forehead, crown of the head
Pavilion	Tabernacle, dwelling
Peculiar	Special, something personally treasured
Peeled	Polished or ground smooth, rubbed bare, bald
Peep	Whisper, as an incantation
Pence	A denarion or denarius, a days wages
Penny	A denarion or denarius, a days wages
Pennyworth	A denarion or denarius, a days wages
Penury	Lack, poverty, need
Peradventure	By chance, maybe, perhaps
Perdition	Destruction
Peres	To divide
Perfect	Complete, spiritually mature
Perform	Finish
Persecute	Chase, to pursue after in order to overtake
Persons	From the Latin persona, mask - the outward appearance of a person
Persuade	To argue or debate Entice Be convinced of something
Pestilent	A person who is like a plague
Phylactery	A small leather box worn on the arm or forehead, containing scripture verses
Piety	Godliness
Pill	Peel
Pilled	To have stripped off skin or bark
Pinnacle	Anything that runs out to a point
Pitch	Encamp, set up a tent, move a tent, a thick, dark, sticky substance
Pitiful	Show pity, be merciful, tender hearted, compassionate
Plain	Complete as is, needing no improvements, simple
Plaister	Plaster
Plait	To braid, fold, or twist
Plaiting	To braid, fold, or twist, intertwining
Platted	Plaited, braided, intertwined
Plead	Legal term meaning to seek a judgment
Pledge	Something held as surety for money due
Pleiades	A cluster of seven stars
Plough	Plow
Plowman	Farmer
Plummet	A plumb-bob
Poll	Of the head: as in a census, or of cutting the hair or beard off the head
Pommel	An ornament at the top of a pillar, a bowl, or crown (anything round)
Ponder	To consider carefully, meditate
Port	Gate
Porter	Gatekeeper, a doorkeeper
Portion	Inheritance or heritage
Post	The runner that carries news, a courier
Potentate	One who possesses power
Potsherd	A fragment of broken pottery
Pottage	Any boiled dish or food
Pourtray	Portray, engrave
Power	Authority
Pransing	Galloping, as a galloping horse
Prate	To talk long and foolishly, babbling, chattering
Prating	To talk long and foolishly, babbling, chattering
Precept	Law
Predestinated	Determined beforehand
Pre-eminence	What is over and above, to be first
Prefer	Promote or outrank Favoritism
Presbytery	An assembly of elders
Presently	Immediately, right now
Press	Crowd
Press upon	Pushed forward toward
Pressed out of	Oppressed beyond
Prevent	To go before, to precede
Prey	Plunder, booty
Prick	Thorns. An iron ox goad, hence the proverb, "to kick against the goads", ie, to offer perilous and useless resistance; a rod with a sharp point
Pricks	Thorns. An iron ox goad, hence the proverb, "to kick against the goads", ie, to offer perilous and useless resistance; a rod with a sharp point
Print	To engrave
Privily	In private, secret, hidden
Privy	Private, private knowledge
Privy to	Private, private knowledge
Procureth	To seek
Profane	Common, unclean, or blasphemous
Profit withal	For the common good
Profited	Advanced
Profound	Gone deeply into
Progenitor	An ancestor, parents
Prognosticator	A fortune teller, a foreteller of the future
Prolonged	Postponed
Proper	Own (this is where we get the word property)
Proper good	Private property
Prophesy	Inspired preaching
Propitiation	What satisfies or appeases, covering, atoning sacrifice
Proselyte	A religious convert
Prospect	Face
Provender	Food provided for animals
Proverb	A dark or puzzling saying
Proverbs	Figures of speech
Provide	Prepare
Providence	Wise guidance
Provoke	Incite or move
Psalm	A song, a melody
Psaltery	A stringed instrument which is plucked
Publican	A regional tax collector who subcontracted the collecting to subordinates
Publish	To say or tell around, to cause to be known, to herald
Puff	To breathe, blow up
Pulse	Peas, beans, lentils, etc vegetables, used for food
Purchase	To gain or acquire
Purge	To rid, cleanse or purify
Purloin	To hide away so as to take wrongfully
Purloining	Stealing, pilfering
Purtenance	Something that pertains to something else, animal intestines, inwards
Push	To gore, used of oxen
Put away	Divorce
Putrifying	A wound that has dead flesh and is decaying, pertaining to gangrene
Pygarg	A species of antelope
Quarrel	A grudge, looking for trouble
Quaternion	A group of four
Quick	Alive, make alive
Quicken	Alive, make alive
Quit	Keep on
QUIT	Blameless, innocent
Quit you	Be brave
Quit you like men	To show one's self a man
Rabbi	Teacher, master
Rabboni	My great teacher, master
Raca	Vain, empty (Aramaic for "spitting")
Rahel	Rachel
Rail	To speak injuriously, to slander, reviling
Railer	To speak injuriously, to slander, reviling
Railing	To speak injuriously, to slander, reviling
Raiment	Clothing, a garment, apparel, covering
Rain	Teach
Rampart	A low outer wall, fortification
Range	Where animals range in search of food. Ranks of soldiers. A stove
Ranging	Running to and fro, wandering
Rank	Fat
Rase	Raze, to scrape bare
Rasor	Razor
Ravening	Plundering
Ravish	To rape, lie with, humble
Raw	Living, alive Uncooked
Raze	To demolish, to strip bare
Reason	Think
Reasoned	Thought
Reasoning	Argument
Rebuke	To reprimand, strongly warn, restrain
Recompense	To repay, reward, restore
Record	A witness or testimony
Redound	To exceed, to be over and above
Refrain	To restrain or hold back
Refuse	Forsake, abandon, reject
Rehearse	To speak, declare, expound
Reins	The area of the kidneys, emotions Modern culture would substitute the idea of the heart, yhe innermost parts of man
Remembrance	(var) (once) in Isaiah 57:8, an idol
Remission	A sending away, passing by, forgiveness
Remit	To send away, to dismiss, set free
Remove	Move or shake
Rend	To break off in pieces, rip apart, tear, to divide
Render	Recompense or repay
Renounce	To speak away, disclaim, to disown
Renown	A great name or well-known
Rent	Something torn away, a division, a split, broken
Rentest	Distort
Repent	To change one's mind and purpose, to regret
Replenish	To fill The present meaning of "refill" is a modern concept
Report	Something commonly known
Reproach	Disgrace, shame
Reprobate	Impure, rejected, disqualified, unapproved, rejected after testing
Reproof	A rebuke, admonition or correction, a scolding
Require	Ask, demand
Requite	To repay, give back, recompense, repay, restore
Rereward	The last, furthest back, the ending, the rear guard, towards the rear
Resemble	To compare, liken
Revelling	A feast resulting in carousing
Reverence	Obeisance, respect to another When used toward people, respect When used toward god, deep respect of the highest order
Reverend	Worthy of the highest respect and reverence, dreadful Inspiring fear Ps 111:9
Revile	To abuse, attack with evil words
Ribband	Cord, ribbon
Rid	Rescue
Riddance	Come to an end, exhaust
Rie	Rye, a grain
Rifle	To plunder, spoil
Ringstraked	Stripes around the body
Riot	Loose living, debauchery
Riotous	Loose living, debauchery
Rising	Swelling
Roe	A young deer
Roll	Scroll
Rude	Unlearned
Rudiment	An elemental thing, first principle
Rudiments	Elements
Rue	A shrubby plant about two feet high, used for medicinal purposes
Rumour	Rumor What is heard, a report
Rush	(var) a reed growing in moist places
Sabbath	A rest, cessation from work
Sackbut	A musical instrument, possibly a harp, or else possibly a brass horn
Sackcloth	A crude garment
Safeguard	Safe keep
Saffron	A perfume and dye derived from the crocus plant
Saints	Men and women of God
Salt	The dead sea
Salutation	An embrace, public recognition, a greeting
Salute	To greet by embracing and kissing
Sanctification	The act of making a thing pure and holy
Sanctify	To be sacred and set apart
Sapphire	A precious stone, bright bluish purple in color
Sardine	A semi precious stone, probably a form of carnelian agate, similar to a ruby
Sardius	A semi precious stone, probably a form of carnelian agate, similar to a ruby
Sardonyx	A semi precious stone, combining qualities of chalcedony and agate
Satan	Adversary
Satiate	To satisfy, fill
Satyr	A creature with the torso and upper body of a man, and from the waist down, a he-goat.  This is a corruption of the original Hebrew word, which simply referred to a male goat.
Save	Except, besides
Savour	Fragrance, pleasure in a good odor or taste
Savoury	Fragrance, pleasure in a good odor or taste
Scabbard	A case or covering for a sword
Scall	Scab or eruption of the skin
Scarce	Just barely or with difficulty
Schoolmaster	Male slave responsible for a boy to take him to school
Scourge	Whip
Scrabble	To scrape with the hands, make a mark
Scrip	A wallet or pouch, apparently somewhat similar to a modern "fanny pack", a bag, a sack
Scripture	That which is written, book, letter
Scull	Skull
Sea	The laver of the temple of Solomon, containing at least 16,000 gallons of water, large basin, or large body of water, like the lake of Galilee
Sect	A group or division, a party
Secure	Safe
Sedition	An uproar, insurrection, dissension
Seethe	To cook by boiling
Selah	Pause
Selfsame	Identical
Selvedge	The end or edge of a woven or knitted fabric
Sepulchere	A place of burial, grave
Serjeant	Sergeant
Servant	Slave
Serve	Enslave
Servile	Laborious
Servitor	Attendant, he who performs as a servant
Setter (forth)	A tale teller
Settle	Ledges around the altar of the temple, the pedestal block
Sevenfold	Multiplied by seven
Sever	To separate
Several	Separate, single, each, individually
Several house	Separated house, segregated place
Severally	Individually
Shambles	Meat market, bloody
Shamefacedness	From shame fastness; Normal proper modesty rooted in a good character
Shapen	Created, brought forth
Share	Plowshare, mattock, or sickle
Sheaf	Bundle of grain
Sheath	A case or covering for a sword
Sheepmaster	Sheep owner
Shekel	A denomination of Hebrew money equal to 220 grains of silver
Sherd	A piece of broken pottery
Sheriff	One knowledgeable in the law
Shew	Show
Shiggaion	A particular type of prayer-psalm of David, Ps 7 the meaning is uncertain
Shigionoth	A particular type of prayer-psalm of Habakkuk, chapter 3 the meaning is uncertain
Shipping	To leave by boat
Shivers	Pieces, splinters
Shoes	Sandals
Should be	Was
Show again	Show
Shroud	Shade or protection
Signet	A seal or stamp
Silverling	Silver coin, shekel
Similitude	Likeness or image of something, representation
Simple	Innocent, honest, straightforward, harmless
Simplicity	Liberality, purity
Sincere	Without deceit, honest
Sincerity	With incorruption
Single	Clear, sound, healthy
Singular	Notable, special
Sith	Since
Situate	Situated
Skilfull	Competence, understanding, wise
Skill	Competence, understanding, wise
Sleight	A deception, trickery, entrapment by deceit
Slime	Asphalt, bitumen
Slips	Branches
Slow bellies	Idle gluttons
Sluices	Damns
Smart	To be sore distressed
Smell	A pleasant odor
Smite	To strike, beat
Smiter	One who beats or strikes
Smote off	To have taken off or away
Snuff	Snort, an expression of disdain, as when a cow snorts at something distasteful. An animal testing the wind
Snuff dish	Implements for working with the incense or lamps in the tabernacle or temple
Snuffers	Implements for working with the incense or lamps in the tabernacle or temple
Sobriety	Self-restraint, discretion, prudence
Sod	To cook by boiling
Sodden	To cook by boiling
Sodomite	A person who engages in homosexual acts
Soever	Where ever
Solace	To delight in, rejoice oneself in
Sometimes	Time past, formerly
Son	Servant
Soothsayer	A foreteller of the future by astrology
Soothsaying	Fortune-telling
Sop	A little bit, morsel
Sore	As an adjective or adverb, intensely or severely, very great
Sottish	Stupid, foolish
Soundness	Health
Space	A period of time
Sped	Past tense of speed
Speed	Success, good fortune
Spikenard	A precious ointment made from a herb in the valerian family
Spindle	One of the implements used in weaving with a loom
Spiritual wickedness	Wicked spirits
Spite	Vexation, anger, grief
Spitefully	To treat shamefully
Spittle	Spit, saliva
Spoil	To plunder or take captive, loot, booty, prey
Spring	Daybreak
Sprinkle	Astonish, startle
Spue	To vomit out
Stablish	Establish
Stablisheth	Establishes, makes steadfast
Stagger	Waver, hesitate As a drunk
Stanched	Ceased, stopped, stood still
Standard	Flag, banner
Stature	Maturity of life, age, adultness
Staves	Rods, clubs
Stay	Remain, sustain, support, something one relies upon
Stayed	Detained, held
Stead	Place
Stedfast	Firm, fixed, steady
Steward	Manager
Stiff hearted	Hard hearted, stubborn
Still	Ongoing, continuous, always
Stirs	Noises, tumults
Stomacher	A decorative garment worn on the chest by women, a fine robe
Store	An ample supply
Stout	Strong, great
Stout hearted	Mighty of heart, brave
Straightaway	Immediately
Strain (at a gnat)	Using a sieve to remove the tiniest of insects (but then not noticing or caring if a camel is swallowed)
Strain at	Strain out
Strait	Tight or narrow, distress
Straiten	Hem in, distress
Straitened	Hindered, impeded
Straitly	Tightly, carefully
Strange	Foreign, foreigner, alien
Stranger	Foreign, foreigner, alien
Strangers	Visitors
Strawed	To scatter or spread on the ground
Strength	Safety, a stronghold or fortress
Striker	One apt to inflict blows or hit another
String	Bond
Strove	Fought
Study	Strive
Stuff	Property, goods, possessions
Suborn	To bribe someone to give false testimony, to induce, bribe, prompt
Subtil	Wise, crafty, deceitful
Suburbs	Open land, pasture
Subvert	To overthrow, destroy, subversion
Succour	To help, aid, assist
Succourer	Helper
Suchlike	Likewise
Suddenly	Hastily
Suffer	Pain, hardship Also used to signify permitting or allowing something to occur
Sufficient	Competent
Sumptuously	Splendidly
Sundered	Parted, separated, divided
Sundry	Various, many
Sup	To dine, to make a meal
Superfluity	Super abundance, overflowing
Superfluous	Over and above, more than enough
Superscription	Inscription, title, a writing over
Superstition	Given to reverence of spirits
Superstitious	Given to reverence of spirits
Supplant	To deceive, defraud
Supple	To soften or clean by washing
Suppliant	Worshipper
Suppliants	Worshippers
Supplication	Petition, an expression of need
Suretiship	A pledge or bond for something
Surety	To become a pledge or bond for something
Surfeiting	An excess of something, intoxication, overindulgence
Surmisings	Suspicions
Swaddled	Diapering or tending to an infant
Swaddling	Diapering or tending to an infant
Swaddling clothes	Clothes used for wrapping
Swelling	Puffed-up, inflated attitudes, conceits
Swine	Pigs
Tabering	To beat, as a drum, to strike (especially the tabret)
Tabernacle	A tent, booth or dwelling
Table	An article of furniture, or also a tablet to be written upon
Tabret	Timbrel, a small drum or tambourine
Tache	A clasp, hooks, fasteners
Tackling	The tackle of a ship
Take no thought	Be not anxious
Take thought	To worry, be anxious
Taken with the manner	Caught in the act
Tale	A tally. A story. A carefully counted number
Talent	A weight, money, or gift
Tares	Darnell, a weed that looks like wheat
Target	A round shield
Tarry	Wait
Taunt	An object of scorn and derision
Tax	Tithe
Taxed	Enrolled
Taxing	Enrolling
Teach	Indicate, point out
Teat	Nipple
Teats	Breasts
Teil	An oak tree
Tekel	Weighed
Tell	To number, count
Temper	To mix or blend together, to mingle, sprinkle, moisten
Temperance	Self control
Temperate	To exercise power or self-control
Tempest	Storm, whirlwind
Tempt	Test
Temptation	Trials
Tempting	Testing
Tender eyed	Having poor vision
Tenon	Projection on the end of a wooden board
Tenor	Intent or purpose
Terrestrial	Upon or belonging to the earth
Testament	A covenant, an agreement
Tetrarch	Ruler of a fourth part of a territory, state, or country
Thankworthy	Worthy of gratitude or merit
The time is now past	The hour is now late
Thence	There, that place
Thereunto	To something, or for something
Thitherward	In that direction, towards
Those who "seemed to be somewhat"	Boasters
Threescore	Sixty
Thrice	Three of something, or three times
Throw	Think
Thummim	Perfections Two objects related to the breastplate of the high priest which enabled him to discern god's will Their exact method of function is no longer known
Thyine	A type of tree somewhat similar to a pine
Tide	Time
Tidings	What is heard, news, a saying
Tillage	Ground that is broken up, plowing
Tiller	Ground that is broken up, plowing
Timbrel	A small hand drum or tambourine
Tire	Shortened form of "attire", a round decorative ornament, turban, head ornament
Tirshatha	Title of a Persian governor
Tithe	The tenth part, 1/10
Tittle	The smallest mark used in writing the law, a point of a letter of the alphabet
Told out	Numbered, tallied
Tongues	Foreign languages
Topaz	A semi precious stone
Totter	Rock or sway, threaten to collapse
Touching	Referencing, pertaining to
Tow	A thread of flax, the short fibers of the flax plant
Towns	Villages
Traffic	To go about and trade, sell, offer merchandise
Traffick	To go about and trade, sell, offer merchandise
Transgression	Wrong-doing, a violation of a law
Translate	To change or remove
Translation	To change or remove
Traversing	Turning, interweaving, entangling
Treatise	A story
Trespass	Wrong-doing, sin
Tribute	Money paid to a conquering country by a conquered country, forced labor
Trodden	Trampled
Trode	Trampled
Trow	To believe, have an opinion, to think
Trump	Trumpet
Turtle	Turtledove, dove
Tutor	A guardian or instructor of a child
Twain	Two
Tyrus	Tyre, city of
Unawares	Unaware
Uncomely	Improper, inappropriate
Uncorruptness	Having integrity, honorable
Unction	Anointing
Under	Subject to
Undergird	Acts 27:17 - bracing wrapped around the lower outside hull of a ship
Undersetters	Supports
Undertake	Be responsible for
Unfeigned	Open, genuine, undisguised
Unicorn	Wild ox
Unjust	Wrongdoing in various forms
Unlade	To discharge, unload
Unlearned	Ignorant, unskilled
Unperfect	Imperfect
Unshod	Barefoot
Unspeakable	Impossible to utter
Unto	By
Untoward	Unruly, perverse, contrary, crooked
Upbraid	To scold, reproach, reprimand
Upharsin	And divided
Upholden	Past tense of "uphold"
Usurp	To take power to one's self, to seize and take hold of
Usury	Interest (of any kind)
Utmost	Furthest part, the end or extremity, most distant
Utter	Something spoken, making something known, to reveal
Vagabond	Wandering
Vain	Empty, useless, foolish
Vainglory	Conceit, egotism
Vale	Valley
Vanity	Uselessness, futility, worthless
Variance	Contention, strife
Vaunt	To boast or brag on one's self
Vehemently	Violently, intensely
Vengeance	Justice
Verily	Truly, surely
Verity	Truth
Vermilion	Red color
Vessel	A receptacle that can be carried, an object. A person
Vestment	Garment, covering, apparel
Vestry	Wardrobe
Vesture	Garment, cloak, clothing
Vex	To distress, torment, to trouble, disturb
Vexation	Torment, anguish
Vial	Bowl, goblet
Victuals	Food, sustenance
Vigilant	Watchful
Vile	Disgusting, defiled, dishonored, loathsome
Vilely	Disgusting, defiled, dishonored, loathsome
Vilest	Lowest, despised
Villany	Folly
Viol	Musical instrument, a kind of harp
Viper	Snake
Virtue	Power, excellence
Visage	Facial appearance, an appearance, form
Vocation	A calling, invitation, summons
Void	Emptiness, empty place, render useless
Volume	A rolled up manuscript
Wake	Be awake, a watchman
Walk	Live
Wallow	To roll
Want	To lack something, be without
Wanted	Lacked
Wanton	Excessive, rebellious
Wantonness	Extreme indulgence in sensual pleasures
Ward	To be in custody, prison, custody
Ware	To be aware, wary
Warp	The yarn extending lengthwise in a loom, and crossed by the woof
Wasteness	Desolation
Waster	A vandal, a destroyer
Waterspout	Waterfall
Wax	To become, change, to grow
Way	Road
Wayfaring man	Traveler, passer-by
Wealth	Riches, health, welfare, good
Well	Good
Well favoured	Attractive, pleasant to look at
Wen	A running sore
Wench	Maidservant
Went out	Came out
Wert	Were, was
Whelp	A son, offspring
When	Whenever
Whence	From where
Whereby	By which
Wherefore	Therefore, Why?, for what reason?, for what cause?
Wherein	In what?
Whereinsoever	Whatever, in whatever respect
Whereinto	Into
Whereof	Of which
Whereon	On which
Whereunto	what is it like? 'to what is it comparable?"
Whereupon	And, so, then
Wherewith	With what, the things with which
Wherewithal	With what, How?, By what means?
Whet	To sharpen
Whether	Which
Whiles	While
Whilst	While
Whit	A small amount, any, a least bit
Whither	Where, which place
Whithersoever	Wherever
Whole	Complete, entire Healthy, normal
Wholesome	Healthy, promoting health
Whoremonger	Sexually immoral person
Whosesoever	Whosoever
Whoso	Whosoever
Whosoever	If anyone
Willes	Cunning devices, methods
Will-worship	Worship originated by man and not god
Wimple	A wide covering, a mantle, a woman's garment, shawl
Winebibber	Wine drinker, a drunkard
Winefat	Trough for treading grapes, a collection trough beneath a winepress
Wise	(var) manner, fashion
Wist	To know something, knew, to have known
Wit	To know something, knew, to become aware of
Withal	With, at the same time, together with
Withholden	Past tense of withhold
Within	Among
Without	(var) outside of, beyond
Without controversy	A settled fact, without argument
Withs	Bowstrings, cords, ropes
Woe	An expression of grief or indignation
Wont	To be accustomed to
Woof	The (crosswise) filling thread in woven fabric
Word	Message
Worketh	Achieves
Wormwood	Undrinkable, bitter to the taste
Worse liking	Displeasing
Worship	Honor
Worth	Become, happen to
Worthy	Deserving of something
Wot	To know something, knew
Wrest	To twist, misdirect, distort, to wrench, to torture by twisting
Wroth	To be provoked, angered
Wrought	Worked, made
Ye	You
Yea	Doubtless, rather, also, but except, indeed then, yes, certainly
Yesternight	Last night
Yonder	There, in that place
